 ################### 
 #........#........# 
 #.##.###.#.###.##.# 
 #.................# 
 #.##.#.#####.#.##.# 
 #....#...#...#....# 
 ####.### # ###.#### 
    #.#       #.#    
#####.# ## ## #.#####
     .  # g #  .     
#####.# ##### #.#####
    #.#       #.#    
 ####.# ##### #.#### 
 #........#........# 
 #.##.###.#.###.##.# 
 #..#.....p.....#..# 
 ##.#.#.#####.#.#.## 
 #....#...#...#....# 
 #.######.#.######.# 
 #.................# 
 ################### 